q	そ
w	ち
e	は
r	の
t	て
y	に
u	と
i	こ
o	み
p	え
a	ど
s	が
f	い
g	ん
h	か
j	う
l	で
;	；
z	わ
x	め
c	る
v	し
b	く
n	な
m	た
,	、
.	。
/	・
dq	ぞ
dw	づ
de	ざ
dr	ふ
dt	ぎ
dy	り
du	つ
di	だ
do	ぬ
dp	ゅ
da	ぼ
ds	べ
df	ひ
dg	ほ
dh	ま
dj	す
dk	や
dl	よ
d;	ょ
dz	ぽ
dx	ぴ
dc	ぜ
dv	ご
db	む
dn	さ
dm	ら
d,	け
d.	ぺ
d/	ゃ
kq	ぃ
kw	ぉ
ke	れ
kr	も
kt	あ
ky	び
ku	ね
ki	ぐ
ko	ゔ
kp	ぱ
ka	ぁ
ks	じ
kd	ば
kf	っ
kg	き
kh	ぶ
kj	ろ
kl	ゆ
k;	ぷ
kz	ぇ
kx	ぅ
kc	せ
kv	お
kb	を
kn	ず
km	げ
k,	へ
k.	ゎ
k/	ぢ
-	ー
~	～
[	「
]	」