w		は
e	な
r		き
t	ね
y	る
u		く
i	の
a		こ
s		て
f		か
g		と
h		う
j		い
l		し
z		ゆ
x		へ
c		す
v		た
b	も
n	に
m	ん
kq		ひ
kw		そ
ke		け
kr		ふ
kt	ぬ
ka	ろ
ks		よ
kd		お
kf	ら
kg		さ
kx	め
kc		ほ
kv		せ
kb	む
dy	み
du	わ
di	り
do		え
dp		や
dh	を
dj		つ
dk	ま
dl	れ
dn		ち
dm		あ
あq	ぁ
いq	ぃ
うq	ぅ
えq	ぇ
おq	ぉ
つq	っ
やq	ゃ
ゆq	ゅ
よq	ょ
うp	ゔ
かp	が
きp	ぎ
くp	ぐ
けp	げ
こp	ご
さp	ざ
しp	じ
すp	ず
せp	ぜ
そp	ぞ
たp	だ
ちp	ぢ
つp	づ
てp	で
とp	ど
はp	ば
ひp	び
ふp	ぶ
へp	べ
ほp	ぼ
はo	ぱ
ひo	ぴ
ふo	ぷ
へo	ぺ
ほo	ぽ
,		、
.		。
/	・
-		ー
~	～
[		「
]		」
ーq	――
、q	‥‥
。q	……
「q	『
」q	』
